#################
#0......#.....#.#
#.###.#.#.###.#.#
#.#...#.#...#.#.#
#.#.###.###.#...#
###.#.....#.#####
#...#.###.#...#.#
#.###.#...#.#.#.#
#.#...#.###.#...#
#.#.###.#.#.#.#.#
#.#.........#.#.#
###.#########.###
#.......#.....#.#
###########.###.#
#.#...#.....#...#
#.#.#.#.#####.#.#
#...#.#.......#.#
###.#.#####.#####
#.#.#.......#...#
#.#.#.#######.#.#
#...#.........#1#
#################