###########
#0...#..#.#
#...#....##
#...#..#..#
#......#.1#
###########