###########
#0.....#..#
#.....#...#
#...##....#
#.##.....1#
###########