#####################################################################################################
#0#.....#.......#...#...............#.........#...#...........#.#.#.#.........#.........#.#.....#...#
#.#.###.#.#######.###########.###.###.###.#.#.###.#.#######.#.#.#.#.#####.#####.#.#######.###.#.#.###
#.#...#...#.#.....#.......#.#.#...#.#.#...#.#.#.........#...#...#...#...........#.#...#...#.#.#.....#
#.#.#####.#.#.###.#.#######.#.###.#.#.###.#####.###########.#.###.###.###.###.#####.#.#.###.#.#####.#
#...#.#...#.....#.#.#...#...#...#.#...#.........#.....#.....#...#...#.#...#.#.......#...#.#...#.#...#
#.###.###.###.#.#.#.#.#.#.###.#########.###.#####.###.#####.###.#.#########.#.###.#####.#.#.#.#.###.#
#...#.#.....#.#.#.#...#.#.#...#...#.......#.#.....#.....#.#.#.#.#.........#.....#...#.#...#.#.#.#.#.#
#.###.#####.#####.###.#.#.###.#.###.#.#.#####.#########.#.#.#.#.#.#.#####.#.#########.#.###.###.#.#.#
#...#.#...........#...#.#...#...#.#.#.#...#...#.#.#...#.......#.#.#.#.......#...#.#.....#...#...#...#
#.###.#####.###.#.#.#.#.#.#####.#.###.###.#####.#.#.#########.###############.#.#.###.###.#####.###.#
#.#.........#...#...#.#.#.#...#...#.#...#.....#.........#.#...............#...#.........#.#.#.......#
#.#.#######.#.###.###.###.###.#.###.#####.#.#######.#####.#.#########.#####.#########.#####.#.#####.#
#.#...#.....#...#.#.#...........#...#.....#...#...........#.#.....#.....#.#.#...#...#.#...#...#.....#
###.#######.#.#####.#.###.###.#.#.#.###.###.###.#############.#.#####.###.#.###.#.#.#####.#.#######.#
#.#...#.#...#.....#.....#...#.#.#.#...#.#...#.....#.#...#...#.#.....#.........#...#.#.#.....#...#...#
#.###.#.#.###.#.#.#####.###.###.#.###.#.#####.#.#.#.#.###.#.###.#######.#####.#.#.#.#.###.#.#.###.###
#...#...#.#.#.#.#.....#.#.....#.#...#.#.#.....#.#.........#.#.....#.......#.....#.#.....#.#.#...#.#.#
#.###.#####.#.#####.###.#######.#.#####.#.###.#######.###.#####.###.#.###.###.#.#####.#####.#.#####.#
#.....#...#.......#.#.#.#.............#.#...#.......#.#.....#.#...#.#...#...#.#...#.#.........#.....#
#.#####.#####.###.###.#.#####.#####.#.#########.#.#####.#.#.#.###.###.###.###.#####.###.###.#####.###
#...#...#.....#.....#.....#.....#...#...#...#...#.#...#.#.#.....#...#.#.#...#.#.#.......#...#.#.#...#
#.###.#######.###.#.###.###.#####.###.###.#.#.###.#.#.#.#####.#.#.###.#.#####.#.###.###.###.#.#.#.###
#.....#.#...#...#.#.#.....#.....#.#...#.#.#.#.#.#...#.#.#.#...#...#.....#.#.#...#.#...#...#...#.....#
#.###.#.#.#.#####.#############.#.###.#.#.#####.#####.###.###.#.#.#.#.#.#.#.###.#.#.#####.###.#.#####
#.#...#...#.....#.#.....#.....#.#...#...#.......#.#.....#...#.#.#...#.#.......#.#.....#.....#.......#
#.#######.#.#####.###.#####.###.#.#####.#.#.#.###.#######.#####.#.#########.#####.#.#####.#####.#.#.#
#...#.....#...#...#...#...#.#...#.....#.#.#.#.....#.........#...#...#.....#...#...#.#.#.......#.#.#.#
#.#.###.###.#.#######.#.###.###.###.#.#######.#####.###.###.###.###.#.#.###.#####.###.#.#####.###.#.#
#.#.#...#...#.......#...........#...#.....#...#.#.#.#.#.#.........#.#.#.#.....#.......#.....#...#.#.#
#.#.#.###.###############.#####.###.#.#.#.###.#.#.###.#######.#.#.#####.#.#####.#.#####.###.#####.#.#
#.#.#.#...#...........#.......#.#.#.#.#.#.....#...#...#...#...#.#...#...#.#.....#.....#.#...#.....#.#
#.#.#.#.#.###.#.###.#.#.#####.###.#########.#####.#.###.#.###.#.#.#.###.#########.#.#######.###.###.#
#.#...#.#...#.#.#...#...#.......#.#...#.#...#.......#...#.....#.#.#.#...#.....#...#.#.......#.#.#...#
###.#####.###################.###.###.#.###.#.#######.###########.#####.#.#####.#####.#######.#.###.#
#.#.#...#...#.#.#.#.........#.#.....#...#.#.#.......#...#.........#.......#...#.#.....#...#.#.....#.#
#.#.#.#######.#.#.###.#.###.###.#.###.###.#.#.###############.#########.###.#.###.#####.###.#####.#.#
#.#.....#.#.#.....#...#.#.#.....#.#...#...#...#...#.....#.....#.......#.#...#...#.#.......#...#...#.#
#.#.#####.#.#.#.#######.#.#.#######.#.###.###.#.#.###.#.#######.#.#.#.#.###.#####.###.#####.#.#####.#
#.#.#.....#.#.#.......#.#.#.....#...#.#.....#.#.#...#.#.#.#.....#.#.#.......#.#...#...#.....#.....#.#
#.###.#.###.#.#.#########.#.#####.#.#######.#.#####.#.#.#.#.#.#######.#######.#.#.#.#########.#.###.#
#.....#.#.#.#.#...#.........#.....#.#...#.#.........#.#.#.#.#.#.........#.#.....#.#.#.......#.#.#.#.#
#.#.###.#.#.#.#.#.###.###.#.#.#.###.#.#.#.###.###.###.###.#############.#.###.###.#.###.#######.#.#.#
#.#.#.#.......#.#.......#.#...#.#...#.#.........#.#.......#...#.....#...#.#.#.#.#.....#.#...#.#...#.#
###.#.#.#.###.#####.#.#################.#.#######.#.#.#.#####.#####.###.#.#.###.#######.###.#.###.#.#
#.....#.#...#.#...#.#.....#.....#...#...#.#.........#.#.........#.................#...#.#...........#
#.###.#.#######.###.###.###.#.###.#.#######.#######.###.###.#.#############.#########.#.###.#######.#
#...#.#.#...#.#...#.#.....#.#...#.#...#.#.....#.#.#...#.#...#.#.....#.............#...#...........#.#
#.###.###.###.###.#####.#.###.#####.###.#######.#.#.#####.#.#.###.###.#####.#.#.#####.#.#####.###.###
#.#...#...#.............#...#.....#.............#...#...#.#.#.#...#...#.#.#.#.#.......#.#.......#.#.#
#######.###.###.#.#####.#.#.#.###.#############.#.###.#.#.#####.#####.#.#.#.###.###.#####.###.###.#.#
#...........#...#.#...#.#.#.....#.#.#...#.#...#.#...#.#.#.#.#...#...#.....#...#...#.....#.#.....#...#
#.###.#.#.###.###.###.#######.#####.###.#.#.###.#.#.###.#.#.#.#####.###.#####.###.###########.#.#.#.#
#...#.#.#.#.#.#.#.........#.......#...#.#.#.......#.....#.#.#.#.........#.......#...#.#.....#.#.#.#.#
#######.###.###.###.###.#.###########.#.#.#.###############.#.#####.#######.#####.###.#.###.#.#.###.#
#...#.....#.......#.#...#...#.....#...#...#.#.....#...#...#...............#.#...#.....#.#.....#.#.#.#
###.#######.###.###.###.#########.#.#####.#.#.#.#.###.#.#.#####.#####.#####.#.###.#.###.#.#####.#.###
#.#.....#.#...#...#...#...#...#.......#.......#.#.#.....#.....#...#.#.#.#.#.....#.#.#...#.#...#...#.#
#.###.###.#.#####.#.#######.#.#.#####.#.#.#####.#######.###.###.###.#.#.#.###.###.#####.#####.#.###.#
#...#...#.......#...#.#...#.#.......#.#.#...#.#.......#...#.#.#.....#.....#...#.....#...#.....#...#.#
###.#.###.###.#.###.#.#.#########.#######.#.#.#######.#####.#.#.#.###.#########.#.#.#####.###.#.###.#
#.......#.#...#...#...#...#...#.#.#.....#.#.#.......#...#.....#.#...#...#.......#.#.#.#...#.#.......#
###.#########.#########.#####.#.#.#####.#.#.#####.###.###.#.#####.#############.###.#.###.#.#.###.###
#...#.#.......#.......#.#.#.............#.#.#.....#.#...#.#.....#.#...#.....#...#...#.....#...#...#.#
#.###.###.#####.#.#.#.#.#.#.#.#.###.###.###.#.#####.#####.#####.#####.###.###.###.###.#.#######.#.#.#
#.....#.........#.#.#.....#.#.#.#...#.#.#.....#.....#.#.#...#.....#...#...#.....#...#.#.#.#.....#...#
#.#.#.###.###.#########.###.#####.#.#.#####.#.#####.#.#.#.###########.###.###.###.#.#####.#######.###
#.#.#.....#.#.#.....#.#...#.#.#...#.#.....#.#...........#.#...#.....#.#.......#...#...#.......#.#...#
#.#######.#.###.###.#.#######.#.###.###.#####.###########.###.#####.#.#.###.#####.###.#.#######.###.#
#...#.#.#.....#...#.#...#.#...#.#.#...#...#.....#.#.#.........#...#.#.#.#...#...#...#...#.#...#.#...#
###.#.#.#######.###.#.###.#.#####.#.#.#.#######.#.#.###.#.###.###.#.#.#####.#.###.#######.#.###.###.#
#...#.#.#...#.....#...#.....#.......#.................#.#.#.......#...#.....#.#...........#.........#
#.###.#.#.###.#######.#.#######.#.#.#######.#########.#####.#.#####.#########.###.#####.#####.#######
#...#...............#.........#.#.#...#...#.#...#.#.#.......#.......#.......#.....#.#...#.#.........#
#.#.#.#######.###########.#########.###.###.#.#.#.#.###.###.#.#########.#######.###.#.#.#.#.#####.#.#
#.#.......#.#.#.#.#...#.......#...#...#.#.#.#.#...........#.#...#.#.........#.....#...#.#...#.#.#.#.#
#.#.#####.#.#.#.#.#.#########.#.#.#.#.#.#.#######.###.#.#####.###.#.#.#######.#########.#.#.#.#.#####
#.#.#.#.#...#...#...#.#.#.......#.#.#...#...#.......#.#...#...#.#...#.......#.#.......#...#.#...#...#
#####.#.###.#######.#.#.#.#####.#####.###.#.#.###.#.#####.#.#.#.#########.###########.#.#.#.###.###.#
#.......#.#.#...............#.#.........#.#.....#.#.....#.#.#.......#...#.#.#.....#.....#.#.....#...#
#.#####.#.#####.#.###########.#.#.#######.###.###.#.#.#####.#.###.#.#.#.#.#.#.#####.#####.#.###.#.#.#
#...#.......#...#.#...#.........#...#.#.....#...#.#.#.#.....#.#...#.#.#.....#...#...#.....#.#...#.#.#
#####.#####.#.#####.#.###.#.#####.###.#########.#.#######.###.#######.#####.#.###.###.#############.#
#...#.#.......#.....#.#.#.#.#.#...#...........#.#.#.#.......#...#.........#.......#.....#.#.#.#.#...#
#.#####.###.#.#######.#.#####.###.#.#######.#.#.###.#######.###.###.#.###.#.#########.###.#.#.#.###.#
#...#...#...#.........#.#.#.....#.....#.....#.#.#.............#.....#.#...#...#.#...#...#.......#.#.#
#.###########.#####.###.#.###.#####.#####.#######.#######.#########.###.#.#.#.#.#.###.#.#.#####.#.#.#
#.......#...#...#.......#...#.#.....#.#.....#.....#.....#...#.........#.#.#.#.....#.#.#.....#...#.#.#
###.#.#####.###.###.#.#.###.#.#######.###.#####.###.#.#.#######.#####.#.#.###.###.#.###.###.###.#.#.#
#...#.........#.#...#.#.#.....#...#.....#...#...#...#.#...........#.#.#.#...#...#.#...#.#...#.......#
#.#######.#.#.###.#.###.#####.#.###.#######.#.###.#####.#####.###.#.#####.###.###.#.#########.#.#####
#.....#...#.#.....#...#.#.....#.......#.#.#.#.#.....#.....#...#.....#.......#.#...#...#.....#.#...#.#
#.#.#######.#.#############.#####.###.#.#.#######.#.###.###.#.#######.###.#####.#.#.#.#.###.###.###.#
#.#.#.#.....#.....#.....#.#.....#...#.....#...#...#...#...#.#...#.#...#.....#...#.#.#.#.#...#.#.....#
#.#.#.#.#########.#####.#.#.###.#.#.###.#####.#.###.#########.#.#.#.#.###.###.#####.#####.#.#.#.#.###
#.#...#.#.....#.............#...#.#.#.#.......#...#...#.......#...#.#.#.....#.....#.....#.#.#...#...#
#.#######.###.###.#.###.###.#.#.#.#.#.#####.#.#########.###.#####.#.#.#.#####.#.#.###.###.###.#.###.#
#.....#.#.#...#...#.#.#.#...#.#...#.....#...#.....#...#...#.#.#...#.#.#.#.#.#.#.#...#.....#...#.#...#
#.###.#.#.###.#.#####.#.#.#.###########.#.#.#######.#####.###.#####.#####.#.#.#####.#####.#.#.###.###
#...#.#.....#.........#.#.#.#...........#.#.........#.............#.....#.....#.......#.....#.#....1#
#####################################################################################################