#########################################
#0....#.......#.......#...#.#...#.#.....#
#####.#.###.#####.###.###.#.#.###.#.#.#.#
#...#.#...#...#.#.#.....#...#.......#.#.#
#.###.#.#######.#####.#.#.#.###.#.#####.#
#.#.....#.#.#.#.#.....#.#.#...#.#.#.#...#
#.#.#.###.#.#.#.#.#.#.###.###.###.#.#.#.#
#...#...#.........#.#.#.....#.#.....#.#.#
#.#####.###.###.###########.#.#####.#.#.#
#.....#.#...#.#.#.#.#.....#.#.......#.#.#
#.###.###.###.###.#.###.#.#######.###.###
#...#.....#.#...#.......#...#...#.#...#.#
###.#.###.#.###.###.#######.#.###.###.#.#
#...#.#.#...#.#.......#.....#.#.#.#.....#
#.#####.#.###.###########.###.#.#.#######
#.....#.#.......#...#...................#
###.#.#.#.#.#.###.#######.#.###.#########
#...#...#.#.#...........#.#.#.#.........#
#######.###.###.#.###########.#.#####.#.#
#...#.....#.#.#.#.#.....#...........#.#.#
#.#####.###.#.#######.###.#####.#.#.#.#.#
#...#...#.#.#...............#.#.#.#.#.#.#
###.#.###.#.#.#####.###.###.#.#.#.#######
#.......#.......#...#.....#.#...#.....#.#
###.#.#######.#######.###.#.#.#.#.#.###.#
#...#.#...#.....#...#...#.#.#.#.#.#.#.#.#
#.#.#####.#.#####.###########.#####.#.#.#
#.#.....#...#...#.......#.#...#...#.....#
#.#.###.#####.#.#####.###.###.###.###.###
#.#...#.#...#.#...#.....#.#.........#...#
#####.#.###.#.###.###.###.#.#.#########.#
#...#.#.........#.....#...#.#.#.........#
#.###.#######.###.###.###.###.#########.#
#.......#...#.#.....#.....#...#...#.....#
#.###.#####.#.#.#####.###.###.#.#.#.###.#
#.#...#.......#.....#.#.....#.#.#.#.#.#.#
#.#######.###.#######.#######.#.#.###.#.#
#...#.......#.#.......#.#.....#.#.#.....#
#.#.###.###.#.###.#.###.###.###.#####.#.#
#.#.#...#...#.#...#.#.........#.......#1#
#########################################